111111111111111111111111111111111111
100000000000000001000010000000000001
100000000000000001000010000000000001
100111100011111001000000011111111001
100000000010000001000000000100000001
100000000010000001111100100100000001
111001111110011000000000100100111111
100001000000010000000000000000000001
100001000000010001001100000000000001
100111110011110001000111110011111001
100000000010000001000000010000001001
100000000010000001100000010000001001
100010011111110000100111111110000001
100010010000000000100000000010000001
111110010000000000100000000010011111
100000011110000100111111110010000001
100000000010000100000000000010000001
100100000011111100000000000011111001
111111110000000000010011110000001001
100000000000000000010010010000001001
100000000010001000010010011111001001
100111110011111111110010000001001001
100000010000000000010000000000000001
100000010000000000010000000000000001
111111111111111111111111111111111111

